15 26
44 44 44 44 44 44 44 44 44 44 44 44 44 44 44 44 44 44 44 44 44 44 44 44 44 44
44 21 21 00 00 00 00 00 00 00 00 00 22 22 00 00 22 22 00 00 00 00 00 21 21 44
44 21 00 00 00 00 00 00 00 00 00 00 00 00 00 00 00 00 00 00 00 00 00 00 21 44
44 00 44 44 44 00 00 00 00 00 00 00 00 00 00 00 00 00 00 00 00 00 00 00 00 44
44 00 44 01 44 00 00 00 00 00 44 44 44 00 00 00 44 44 44 00 00 00 00 00 00 44
44 00 44 44 44 00 00 00 00 00 44 23 44 00 00 00 44 23 44 00 00 00 00 00 00 44
44 00 00 00 00 00 00 00 00 00 44 44 44 00 00 00 44 44 44 00 00 00 00 00 00 44
44 00 00 00 00 00 00 00 00 00 00 00 00 00 00 00 00 00 00 00 00 00 00 00 00 44
44 00 00 00 00 00 00 00 00 00 22 00 00 00 00 22 00 00 00 00 00 00 00 00 00 44
44 00 00 00 22 00 00 00 00 00 00 00 00 00 00 00 00 44 44 44 00 00 00 00 00 44
44 00 00 00 00 00 00 00 00 00 22 00 00 00 00 22 00 44 23 44 00 00 00 00 00 44
44 00 00 00 00 00 00 00 00 00 00 00 00 00 00 00 00 44 44 44 00 00 00 00 00 44
44 21 00 00 00 00 00 00 00 00 00 00 00 00 00 00 00 00 00 00 00 00 00 00 21 44
44 21 21 00 00 00 00 00 00 00 00 00 00 00 22 00 22 00 00 00 00 00 00 21 21 44
44 44 44 44 44 44 44 44 44 44 44 44 44 44 44 44 44 44 44 44 44 44 44 44 44 44