11 16
44 44 44 44 44 44 44 44 44 44 44 44 44 44 44 44
44 21 21 00 00 00 00 00 00 00 00 00 00 21 21 44
44 21 01 00 00 00 00 00 00 00 00 00 00 00 21 44
44 00 00 00 00 00 00 00 00 00 00 00 00 00 00 44
44 00 00 00 00 00 00 00 00 00 44 44 44 00 00 44
44 00 00 00 00 00 00 00 00 00 44 00 44 00 00 44
44 00 00 00 00 00 00 00 00 00 44 44 44 00 00 44
44 00 00 00 00 00 00 00 00 00 00 00 00 00 00 44
44 21 00 00 00 00 00 00 00 00 00 00 00 00 21 44
44 21 21 00 00 00 00 00 00 00 00 00 00 21 21 44
44 44 44 44 44 44 44 44 44 44 44 44 44 44 44 44