11 16
05 05 05 05 05 05 05 05 05 05 05 05 05 05 05 05
05 00 00 00 00 00 00 00 00 00 00 00 00 00 00 05
05 00 00 00 00 00 00 00 00 00 00 00 00 00 00 05
05 00 00 00 00 00 00 00 00 00 00 00 00 00 00 05
05 00 00 00 00 00 00 00 00 00 05 05 05 00 00 05
05 00 00 00 00 00 00 00 00 00 05 01 05 00 00 05
05 00 00 00 00 00 00 00 00 00 05 05 05 00 00 05
05 00 00 00 00 00 00 00 00 00 00 00 00 00 00 05
05 00 00 00 00 00 00 00 00 00 00 00 00 00 00 05
05 00 00 00 00 00 00 00 00 00 00 00 00 00 00 05
05 05 05 05 05 05 05 05 05 05 05 05 05 05 05 05