10 15
44 44 01 81 81 81 81 81 81 81 81 81 02 44 44 
44 81 00 00 00 00 00 44 00 00 00 00 00 81 44 
23 81 00 00 00 00 44 21 44 00 44 31 00 81 22 
00 81 00 00 00 00 00 44 00 44 21 44 00 81 00 
00 81 00 00 00 44 00 00 00 00 44 00 00 81 33 
03 81 00 00 44 21 44 00 00 00 00 00 00 81 02 
00 81 00 00 32 44 00 00 00 44 00 00 00 81 00 
23 81 00 00 00 00 00 00 44 21 44 00 00 81 22 
44 81 00 00 00 00 00 00 00 44 00 00 00 81 44 
44 44 02 81 81 81 81 81 81 81 81 81 03 44 44 
