20 20
81 81 81 81 81 81 81 81 81 81 81 81 81 81 81 81 81 81 81 81 
81 23 31 00 00 00 00 03 00 23 23 00 00 00 00 00 00 31 23 81 
81 31 44 44 44 44 44 44 44 44 44 44 44 44 44 44 44 44 31 81 
81 00 44 22 33 00 00 00 00 22 22 00 00 02 00 00 22 44 00 81 
81 00 44 00 48 48 48 48 48 48 48 48 48 48 48 48 00 44 00 81 
81 00 44 00 48 21 44 01 00 21 21 00 02 44 21 48 00 44 00 81 
81 00 44 00 48 44 44 00 00 00 00 00 00 44 44 48 00 44 00 81 
81 00 44 00 48 00 00 00 00 44 00 44 00 00 02 48 00 44 00 81 
81 00 44 00 48 44 00 00 44 21 44 21 44 00 00 48 00 44 00 81 
81 23 44 22 48 21 00 00 00 44 21 44 00 00 21 48 22 44 23 81 
81 23 44 22 48 21 00 00 44 21 44 21 44 00 21 48 22 44 23 81 
81 00 44 00 48 00 00 00 00 44 00 44 00 00 00 48 00 44 00 81 
81 00 44 00 48 04 00 00 00 00 00 00 00 00 02 48 00 44 00 81 
81 00 44 00 48 44 44 44 44 44 44 44 44 44 44 48 00 44 00 81 
81 00 44 00 48 21 44 44 32 21 21 34 44 44 21 48 00 44 00 81 
81 00 44 00 48 48 48 48 48 48 48 48 48 48 48 48 00 44 00 81 
81 00 44 22 02 00 00 00 00 22 22 00 00 00 00 33 22 44 00 81 
81 31 44 44 44 44 44 44 44 44 44 44 44 44 44 44 44 44 31 81 
81 23 31 00 03 00 00 00 00 23 23 00 00 00 00 00 00 31 23 81 
81 81 81 81 81 81 81 81 81 81 81 81 81 81 81 81 81 81 81 81 
