10 15
44 44 44 44 44 44 44 44 44 44 44 44 44 44 44
44 00 21 00 00 00 00 00 00 00 00 00 00 00 44
44 00 21 00 00 00 00 00 00 00 00 00 00 00 44
44 00 21 00 00 00 00 00 00 00 00 00 32 02 44
44 00 00 00 00 00 00 00 00 00 00 00 00 33 44
44 00 00 00 00 00 00 00 00 00 00 00 00 00 44
44 00 00 00 00 00 00 00 00 00 00 00 00 00 44
44 00 00 00 00 00 00 00 00 00 00 00 00 00 44
44 00 00 00 00 00 00 00 00 00 00 31 00 01 44
44 44 44 44 44 44 44 44 44 44 44 44 44 44 44