10 15
44 44 01 00 00 00 00 00 00 00 00 00 00 44 44 
44 22 00 00 00 00 00 00 00 00 00 00 00 22 44 
02 00 00 00 44 44 22 00 00 22 44 44 00 00 02 
00 00 00 00 44 21 00 00 00 00 21 44 00 00 00 
00 00 00 00 22 00 00 00 31 00 00 22 00 00 00 
00 00 00 00 22 00 00 03 00 00 00 22 00 00 00 
00 00 00 00 44 21 00 00 00 00 21 44 00 00 00 
02 00 00 00 44 44 22 00 00 22 44 44 00 00 02 
44 22 00 00 00 00 00 00 00 00 00 00 00 22 44 
44 44 00 00 00 00 00 00 00 00 00 00 00 44 44 
