10 15
44 44 44 44 44 44 44 44 44 44 44 44 44 44 44
44 02 21 44 22 00 00 00 00 00 22 44 21 02 44
44 21 44 00 00 00 00 00 00 00 00 00 44 21 44
44 44 00 00 04 00 00 23 23 00 00 00 00 44 44
44 00 00 00 00 00 00 00 00 00 00 00 00 00 44
44 00 23 00 00 00 00 00 00 00 00 00 00 00 44
44 44 00 00 00 00 00 00 00 00 00 00 00 44 44
44 21 44 00 00 00 01 00 00 00 00 23 44 21 44
44 02 21 44 22 00 00 00 23 00 22 44 21 03 44
44 44 44 44 44 44 44 44 44 44 44 44 44 44 44