10 15
81 81 81 81 81 81 81 81 81 81 81 81 81 81 81
81 00 21 00 00 00 00 00 00 00 00 00 00 00 81
81 00 21 00 00 00 00 00 00 00 00 00 00 00 81
81 00 21 00 00 00 00 00 00 00 00 00 32 02 81
81 00 00 00 00 00 00 00 00 00 00 00 00 33 81
81 00 00 00 00 00 00 00 00 00 00 00 00 00 81
81 00 00 00 00 00 00 00 00 00 00 00 00 00 81
81 00 00 00 00 00 00 00 00 00 00 00 00 00 81
81 00 00 00 00 00 00 00 34 00 00 31 00 01 81
81 81 81 81 81 81 81 81 81 81 81 81 81 81 81