12 18
44 44 44 44 44 44 44 44 44 44 44 44 44 44 44 44 44 44
44 21 21 00 00 44 22 22 00 23 23 44 00 00 21 21 00 44
44 00 44 00 00 00 00 00 00 00 00 00 00 44 00 00 00 44
44 00 00 00 00 00 01 00 00 00 00 00 00 00 00 00 00 44
44 44 00 00 00 00 00 00 00 00 00 00 00 00 00 00 44 44
44 00 00 00 02 00 00 00 00 00 00 00 03 00 00 00 00 44
44 00 44 00 00 00 00 00 00 00 00 00 00 00 44 00 00 44
44 00 00 00 04 00 00 00 00 00 04 00 00 00 00 00 00 44
44 22 00 00 00 00 00 00 00 00 00 00 00 00 00 00 22 44
44 44 44 44 44 44 44 44 44 44 44 44 44 44 44 44 44 44
44 02 02 44 00 00 44 00 00 44 00 00 44 00 00 44 02 02
44 44 44 44 44 44 44 44 44 44 44 44 44 44 44 44 44 44